junger	Mensch	der
elegante	Frau	die
älterer	Mann	der
kleines	Kind	das
heilige	Familie	die
falscher	Freund	der
heimliche	Freundin	die
strenger	Vater	der
heilige	Mutter	die
großer	Bruder	der
böse	Schwester	die
verlorener	Sohn	der
rebellische	Tochter	die
falscher	Kollege	der
neue	Kollegin	die
mächtiger	Chef	der
eiserne	Chefin	die
neugieriger	Nachbar	der
klatschende	Nachbarin	die
unerwünschter	Gast	der
weiser	Lehrer	der
strenge	Lehrerin	die
frecher	Schüler	der
stille	Schülerin	die
falscher	Arzt	der
kluge	Ärztin	die
wütender	Kunde	der
treue	Kundin	die
rasender	Fahrer	der
verdächtige	Person	die
weinendes	Baby	das
unerwarteter	Besucher	der
versammelte	Gruppe	die
eigenes	Haus	das
renovierte	Wohnung	die
offene	Tür	die
zerbrochenes	Fenster	das
runder	Tisch	der
knarrendes	Bett	das
bequemes	Sofa	das
ungültiger	Schlüssel	der
rotes	Licht	das
weicher	Teppich	der
kalte	Dusche	die
warmes	Wasser	das
geschnittenes	Brot	das
Französischer	Salat	der
grüner	Tee	der
brauner	Zucker	der
gekochtes	Ei	das
gefangener	Fisch	der
kaltes	Bier	das
scharfes	Messer	das
süßes	Dessert	das
freier	Markt	der
lange	Zeit	die
neuer	Tag	der
dunkle	Nacht	die
nächste	Woche	die
neues	Jahr	das
genaue	Uhr	die
schönes	Wochenende	das
kurze	Pause	die
unsichere	Zukunft	die
konkreter	Plan	der
unerwartetes	Ende	das
entgleister	Zug	der
lange	Reise	die
schmale	Straße	die
hölzerne	Brücke	die
harte	Arbeit	die
gute	Frage	die
richtige	Antwort	die
komplexes	Problem	das
großes	Projekt	das
relevante	Information	die
detaillierter	Bericht	der
unterzeichneter	Vertrag	der
großer	Erfolg	der
erfolgreiche	Zusammenarbeit	die
tiefer	Schmerz	der
reine	Freude	die
wahre	Liebe	die
intensives	Gefühl	das
tiefer	Schlaf	der
weite	Welt	die
harte	Realität	die
nackte	Wahrheit	die
finanzielle	Sicherheit	die
unbekanntes	Risiko	das
letzte	Chance	die
verbotene	Stadt	die
erobertes	Land	das
wahre	Geschichte	die
blauer	Himmel	der
helle	Sonne	die
starker	Wind	der
welliges	Meer	das
nationale	Politik	die
starke	Wirtschaft	die
goldene	Regel	die
endgültige	Entscheidung	die
direkter	Einfluss	der
heikle	Situation	die
abgenutzte	Schuhe	die
leere	Batterie	die
verlegtes	Kabel	das
defekte	Fernbedienung	die
leere	Box	die
gewartete	Maschine	die
erhöhter	Preis	der
unknackbares	Passwort	das
kostenlose	App	die
langweiliger	Film	der
laute	Musik	die
riskantes	Spiel	das
teures	Hobby	das
heikle	Sache	die
reales	Beispiel	das
erste	Wahl	die
erfolgloser	Versuch	der
erste	Hilfe	die
bedingungslose	Unterstützung	die
positives	Ergebnis	das
unerfüllter	Wunsch	der
echter	Name	der
unbegrenzte	Macht	die
starker	Wille	der
drohende	Krise	die
kulturelles	Erbe	das
künstliche	Intelligenz	die
tiefe	Einsicht	die
leichte	Brise	die
ruhige	Stimme	die
schwere	Last	die
falsche	Annahme	die
kluger	Rat	der
frische	Luft	die
schnelle	Reaktion	die
tiefe	Sehnsucht	die
sanfte	Melodie	die
klare	Sicht	die
lebendige	Fantasie	die
harte	Konsequenz	die
dichte	Wolke	die
moderne	Technologie	die
glänzende	Oberfläche	die
freundliches	Lächeln	das
weites	Feld	das
steiler	Abhang	der
goldener	Ring	der
erster	Blick	der
dunkle	Gasse	die
starker	Euro	der
hoher	Prozentwert	der
vereintes	Deutschland	das
kleine	Million	die
großes	Unternehmen	das
dynamisches	Berlin	das
schwieriger	Fall	der
erste	Seite	die
verehrter	Herr	der
instabile	Eurozone	die
führende	Partei	die
zuständiger	Minister	der
effizientes	System	das
relevanter	Bereich	der
langer	Prozess	der
engagierter	Bürger	der
kompliziertes	Verfahren	das
staatliches	Programm	das
deutsches	Bundesland	das
demokratisches	Parlament	das
öffentliches	Interesse	das
politischer	Skandal	der
steigende	Nachfrage	die
tägliche	Nachrichten	die
starkes	Wachstum	das
hoher	Gewinn	der
kritische	Lage	die
klare	Strategie	die
offizielles	Statement	das
drohende	Gefahr	die
digitale	Transformation	die
wachsende	Ungleichheit	die
wichtiger	Beschluss	der
globaler	Wettbewerb	der
tiefgreifende	Reform	die
sorgfältige	Analyse	die
rechtliche	Grundlage	die
konkrete	Maßnahme	die
geschicktes	Eingriff	der
wachsende	Unsicherheit	die
innovatives	Konzept	das
vollständiger	Schutz	der
dringender	Appell	der
schwarzes	Schaf	das
übertragener	Sinn	der
Chinesische	Mauer	die
bissiger	Hund	der
